WWWWWWWWWWWWWWWWWWWWWWWWWWWWWWWWWWWWWW
WRRE REEEDEEEEEEEEEEEEEEEEEEEEEEEEEEEW
WEDEEREREEEEEEEEEEEEEEEEEEEEEEEEEEEEEW
WEPEEEEEEEEEEEEEEEEEEEEEEEEEEEEEEEEEEW
WEEEEEEEEEEE EEEEEE EEEEEEEEEEEEEXEEEW
WEEEEEEEEEEEEEEEEEEEEEEEEEEEEEEEEEEEEW
WEEEEEEEEEDEEEEEDEE EEEEEEEEEEEEEEEEEW
WEEEEEEEER R EEEEEEEEEEEEEEEEEDEEEEEEW
WEEEEEEEEE EEEEEEEEDDEEEEEEEEEEEEEEEEW
WEEEEEEEEEDWEEEEEEEEEEEEEEEEEEEEEEEEEW
WEEEEEEEEEEEEEEEEEEEEEEEEEEEEEEEEEEEEW
WWWWWWWWWWWWWWWWWWWWWWWWWWWWWWWWWWWWWW