WWWWWWWWWWWWWWWWWWWWWWWWWWWWWWWWWWWWWWWWWWWWWWWWWWWWWWWWWWWWWWWWWWWWWWWWWWWWWW
WEEEEEE EEDER EEEEEREREEEEEEE EEEREEEEEEEEEEE EEDER EEEEEREREEEEEEE EEEREEEEEW
WERPREEEEEE EEEEEEEEEREEEEEEEE EEEEEEEEEREREEEEEE EEEEEEEEEREEEEEEEE EEEEEEEEW
WEEEEEEEEEE EE EEEEEREREEREEEEEEERE EEEEEEEEEEEEE EE EEEEEREREEREEEEEEERE EEEW
WRE  EEEEEEEEEREEEEEEREEEREEEREEREEEREERE  EEEEEEEEEREEEEEEREEEREEEREEREEEREEW
WRER EEEEEEEEERREEREEEEEREEREEEEEREE EERER EEEEEEEEERREEREEEEEREEREEEEEREE EEW
WEERREE EEEEEEEEEEEEE REEREEEEEEEREERREEERREE EEEEEEEEEEEEE REEREEEEEEEREERREW
WWWWWWWWWWWWWWWWWWWWWWWWWWWWWWWEEEEEEREWWWWWWWWWWWWWWWWWWWWWWWWWWWWWWEEEEEEREW
WEEEEEEDEEEEEEEEEEEEEEEEEEEEEEEEEEEEEREEEEEEEEEEEEEEEEEEEEEEEEDEEEEEEEEEEEEREW
WEEEEEEREEEEEEEEEEEEEEEEREEDEEEEEEEEEEEEEEEEEREEEEEEEEEEEEEEEEREEEEEEEEEEEEEEW
WEEEERRREEEEEEEEEEEEEEEER  REEEEEEEEEEEEDEERRREEEEEEEEEEEEEEEER  REEEEEEEEEEEW
WEEREEREEEEEEEEEEEEEEEEERREREEDEEEEEEEEEEREEREEEEEEEEEEEEEEEEERREREEDEEEEEEEEW
WEREEEREEEEEEEEEREEEDEEEEEEEEEREEEEEEEEEREEEREEEEEEEEERDEEEEEEEEEEEEREEEDEEEEW
WEDREEEEEEEEEEEERRREREEEEEEEEEEEEEEEEEEEDREEEEEEEEEEEERRREREEEEEEEEEDEEEEEEEEW
WEEEEEEEEWWWWWWWWWWWWWWWWWWWWWWWWWWWWWWEEEEEEEEWWWWWWWWWWWWWWWWWWWWWWWWWWWWWWW
WEEEEEEEEEEEEEEEEEEEEEEEEEEEREEEEEEEEEEEEEEEEEEEEEEEEDEEEEEEEEEEEEREEEEEEEEEEW
WEEEEEEEEEERREEREEEEEEEEEREEEEEER EEEEEEEEEEEEEEERREEREEEEEEEEEREEEEEER EEEEEW
W  EEREEEEEEEREEEEEEEEEEEEEEEDEEEREEEEX  EEREEEEEEEREEEEEEEEEEEEEEEEEEEREEEEEW
WEEEEREEEE EEEE EEE   EEEREEREEEEREEEEEEEEEREEEE EEEE EEE   EEEREERDEEEREEEEEW
WEE EREE ERERERREEEEEEEEEREEREEEEEEEEEEEE EREE ERERERREEEEEEEEEREEREEEEEEEEEEW
WEDEEEEEREEEE EEEEEEE EEEREEEREEEEEEEEEEEEEEEEREEEE EEEEEEE EEEREEEREEEEEEEEEW
WEEEEEE EEDER EEEEEREREEEEEEE EEEREEEEEEEEEEE EEDER EEEEEREREEEEEEE EEEREEEEEW
WEE EREE ERERERREEEEEEEEEREERDEEEEEEEEEEE EREE ERERERREEEEEEEEEREERDEEEEEEEEEW
WEEEEEEEEEERREEREEEEEEEEEREEEEEER EEEEEEEEEEEEEEERREEREEEEEEEEEREEEEEER EEEEEW
WEEEEEEEREEEE EEEEEEE EEEREEEREEEEEEEEEEEEEEEEREEEE EEEEEEE EEEREEEREEEEEEEEEW
WWWWWWWWWWWWWWWWWWWWWWWWWWWWWWWWWWWWWWWWWWWWWWWWWWWWWWWWWWWWWWWWWWWWWWWWWWWWWW