WWWWWWWWWWWWWWWWWWWWWWWWWWWWWWWWWWWWWW
WRPR REEEDEEEEEEEEEEEEEEEEEEEEEEEEEEEW
WEDEEREREEEEEEEEEEEEEEEEEEEEEEEEEEEEEW
WEEEEEEEEEEEEEEEEEEEEEEEEEEEEEEEEEEEEW
WEEEEEEEEEEE EEEEEE EEEEEEEEEEEEEXEEEW
WEEEEEEEEEEEEEEEEEEEEEEEEEEEEEEEEEEEEW
WEEEEEEEEEDEEEEEDEE EEEEEEEEEEEEEEEEEW
WEEEEEEEER R EEEEEEEEEEEEEEEEEDEEEEEEW
WEEEEEEEEE EEEEEEEEDDEEEEEEEEEEEEEEEEW
WEEEEEEEEEDWEEEEEEEEEEEEEEEEEEEEEEEEEW
WEEEEEEEEEEEEEEEEEEEEEEEEEEEEEEEEEEEEW
WWWWWWWWWWWWWWWWWWWWWWWWWWWWWWWWWWWWWW