WWWWWWWWWWWWWWWWWWWWWWWWWWWWWWWWWWWWWW
WEEE REEEDEEEEEEEEEEEEEEEEEEEEEEEEEEEW
WEEEEREREEEEEEEEEEEEEEEEEEEEEEEEEEEEEW
WEEEEEEEEEEEEEEEEEEEEEEEEEEEEEEEEEEEEW
WEEEEEEEEEEE EEEEEE EEEEEEEEEEPDDXEEEW
WEEEEEEEEEEEEEEEEEEEEEEEEEEEEEEEEEEEEW
WEEEEEEEEEEEEEEEDEE EEEEEEEEEEEEEEEEEW
WEEEEEEEEEEEEEEEEEEEEEEEEEEEEEEEEEEEEW
WEEEEEEEEEEEEEEEEEED EEEEEEEEEEEEEEEEW
WEEEEEEEEEDWEEEEEEEEEEEEEEEEEEEEEEEEEW
WEEEEEEEEEEEEEEEEEEEEEEEEEEEEEEEEEEEEW
WWWWWWWWWWWWWWWWWWWWWWWWWWWWWWWWWWWWWW