WWWWWWWWWWWWWWWWWWWWWWWWWWWWWWWWWWWWWW
WEEE REEEDEEEEEEEEEEEEEEEEEEEEEEEEEEEW
WEEEPREREEEEEEEEEEEEEEEEEEEEEEEEEEEEEW
WEEEEEEEEEEEEEEEEEEEEEEEEEEEEEEEEEEEEW
WEEEEEEEEEEE EEEEEE EEEEEEEEEEEEEXEEEW
WEEEEEEEEEEEEEEEEEEEEEEEEEEEEEEEEEEEEW
WEEEEEEEEEEEEEEEDEE EEEEEEEEEEEEEEEEEW
WEEEEEEEEEEEEEEEEEEEEEEEEEEEEEDEEEEEEW
WEEEEEEEEEEEEEEEEEEDDEEEEEEEEEEEEEEEEW
WEEEEEEEEEDWEEEEEEEEEEEEEEEEEEEEEEEEEW
WEEEEEEEEEEEEEEEEEEEEEEEEEEEEEEEEEEEEW
WWWWWWWWWWWWWWWWWWWWWWWWWWWWWWWWWWWWWW