WWWWWWWWWWWWWWWWWWWWWWWWWWWWWWWWWWWWWW
WEEEDREEEDEEEEEEEEEEEEEEEEEREEEEEEEEEW
WEEEEREREEEEEEEEEEEEEEREEE REPXEREEEEW
WEEEEEEEEEEEEEEEEEEREEEEEEEREEEEEEEEEW
WEEEREEEEEEE EEEEEEREEEEEEEDEEEEDEEEEW
WEEEREEEEREEEEEEEEEREEEEEEEEEEREEEEEEW
WWWWEEWWWWWWWWWW   WWWWWWWWWWWWWWWWWWW
WEEEEEEEEEEEEEEED   EEEEEEEEEEEEEEEEEW
WDEREEEEEEEREWWWWW  WWWWWWEEEEDEEEEEEW
WEERREEEEEEREEEEEEEDDEEEEEEEEEEREEEEEW
WEEEDEEEEEDWEEEEEEEEEEEEERDREEEEEEDEEW
WEEEEEEEEEEEEEEEREREEEEDEEEEEEEDEEDEEW
WWWWWWWWWWWWWWWWWWWWWWWWWWWWWWWWWWWWWW