WWWWWWWWWWWWWWWWWWWWW
WPXDDREEEDEEEEEREEEEW
WEEEEREREEEEEEEREEEEW
WEEEEEEEEEEEEEEEEEEEW
WEEEEEEEEEEE EEEEEE W
WEEEEDERRDEEEEEEEEEEW
WEEEEEWWW EEEDEEEEDDW
WEEEEEEEREEEEEEEEEEEW
WEEDEEEEEEEREEEEEEEEW
WEEEEEERDEWWWEEDEEEEW
WEEEERD REEEEEEEREEEW
WWWWWWWWWWWWWWWWWWWWW