WWWWWWWWWWWWWWWWWWWWWWWWWWWWWWWWWWWWWW
WEEDDREEEDEEEEEEEEEEEEDEEEEEEEEDEEEEEW
WEEEEREREEEEREEWEEEEEWEEEEEEEEEEEDEEEW
WWWWWWWWWWWWWWWWEEEEEWWWWWWWWWWWWWWWWW
WEEEREEERREE EEEEEE EEREEEEEEEEEEEDEEW
WEEEDEEEDEEEEEEWEEEEEEREEDDEEEEEEEEEEW
WWWWWWWWWWWWWWWWDEEEEEWWWWWWWWWWWWWWWW
WEEEDEDEEEEEE  REEEPEEEEEEEEEEDEEEEEEW
WEEEEEEEDEEREEEREEEDDEWEEEEEDEEEEEEEXW
WWWWWWWWWWWWWWWWEEEREEWWWWWWWWWWWWWWWW
WEEEEEEEEEEEEEEEEEEEEEEEEEEEEEEEDDEEEW
WEEEEEEDEEEEEEEWEEEEEEWEEEEEEEEEEEEEEW
WEEEEEEEEEDEEEEEEEEEEEEEEEEDEEEEEEEEEW
WWWWWWWWWWWWWWWWWWWWWWWWWWWWWWWWWWWWWW